conspicuous: obvious to the eye or mind
adversary: someone who offers opposition
aplomb: great coolness and composure under strain
aptitude: inherent ability
attentive: taking heed
banish: send away from a place of residence, as for punishment
barricade: block off with barriers
bluff: deceive someone about your strength or intentions
brackish: slightly salty
brandish: move or swing back and forth
circumference: the size of something as given by the distance around it
commotion: confused movement
concoction: any foodstuff made by combining different ingredients
contortion: a tortuous and twisted shape or position
counter: speak in response
cunning: shrewdness as demonstrated by being skilled in deception
debris: the remains of something that has been destroyed
defiance: a hostile challenge
deft: skillful in physical movements; especially of the hands
destination: the place designated as the end, as of a race or journey
diminish: decrease in size, extent, or range
disdain: lack of respect accompanied by a feeling of intense dislike
dismal: causing dejection
dispel: force to go away
eavesdrop: listen without the speaker's knowledge
egregious: conspicuously and outrageously bad or reprehensible
ember: a hot, smoldering fragment of wood left from a fire
emerge: come out into view, as from concealment
engross: consume all of one's attention or time
exasperation: a feeling of annoyance
exhilarate: fill with sublime emotion
jargon: technical terminology characteristic of a particular subject
falter: move hesitatingly, as if about to give way
foresight: seeing ahead; knowing in advance; foreseeing
fragrance: a distinctive odor that is pleasant
misgiving: uneasiness about the fitness of an action
momentum: an impelling force or strength
monotonous: sounded or spoken in a tone unvarying in pitch
multitude: a large indefinite number
furtive: secret and sly or sordid
grueling: characterized by effort to the point of exhaustion
gusto: vigorous and enthusiastic enjoyment
habitation: the act of dwelling in or living permanently in a place
hasten: speed up the progress of; facilitate
headway: forward movement
ignite: cause to start burning
illuminate: make free from confusion or ambiguity
impending: close in time; about to occur
imperious: having or showing arrogant superiority
jabber: talk in a noisy, excited, or declamatory manner
materialize: come into being; become realityjostle: make one's way by pushing or shoving
jut: extend out or project in space
kindle: call forth, as an emotion, feeling, or response
knoll: a small natural hill
luminous: softly bright or radiant
malleable: easily influenced
precipice: a very steep cliff
meander: move or cause to move in a winding or curving course
meticulous: marked by extreme care in treatment of details
muster: gather or bring together
narrate: give a detailed account of
obscure: not clearly understood or expressed
ominous: threatening or foreshadowing evil or tragic developments
outlandish: noticeably or extremely unconventional or unusual
persistent: stubbornly unyielding
pertinent: having precise or logical relevance to the matter at hand
plenteous: affording an abundant supply
potential: existing in possibility
pristine: completely free from dirt or contamination
scarcity: a small and inadequate amount
quell: overcome or allay
recluse: one who lives in solitude
recuperate: restore to good health or strength
replenish: fill something that had previously been emptied
repugnant: offensive to the mind
vulnerable: capable of being wounded or hurt
restitution: a sum of money paid in compensation for loss or injury
sabotage: destroy property or hinder normal operations
scurry: move about or proceed hurriedly
serenity: the absence of mental stress or anxiety
sociable: friendly and pleasant
somber: grave or even gloomy in character
specimen: an example regarded as typical of its class
stamina: enduring strength and energy
subside: wear off or die down
versatile: able to move freely in all directions
weather: face and withstand with courage
swagger: a proud stiff pompous gait
swarm: move in large numbers
tactic: a plan for attaining a particular goal
terse: brief and to the point
translucent: allowing light to pass through diffusely
uncanny: surpassing the ordinary or normal
unsightly: unpleasant to look at
apprehensive: in fear or dread of possible evil or harm
vigilant: carefully observant or attentive
waft: be driven or carried along, as by the air
waver: pause or hold back in uncertainty or unwillingness
zeal: a feeling of strong eagerness
conventional: (adj) based on or in accordance with what is generally done or believed
benevolent: (adj) friendly, helpful, kind
debilitate: (v) make someone weak and infirm
revelation: (n) a surprising and previously unknown fact
uniformity: (n) overall sameness, homogeneity, or regularity
modest: (adj) unassuming or moderate in the estimation of one's abilities or achievements
diminished: (adj) made smaller or less
empathy: (n) the ability to understand and share the feelings of another
bewildered: (v) cause (someone) to become perplexed and confused
erudition: (n) the quality of having or showing great knowledge or learning; scholarship
prescient: (adj) having or showing knowledge of events before they take place
bombastic: (adj) meant to sound important or impressive but is not sincere or meaningful
mollify: (v) appease the anger or anxiety of (someone)
novelty: (n) the quality of being new, original, or unusual
impartial: (adj) treating all equally; fair and just
benign: (adj) kindly, gracious, favorable, harmless
anachronistic: (adj) out-of-date, not attributed to the correct historical period
debilitate: (v) hinder, delay, or weaken
perpetuate: (v) make continue indefinitely
mitigate: (v) make less severe, serious, or painful
candid: (adj) truthful and straightforward; (of a photograph) taken informally, not posed
exonerate: (v) absolve (someone) from blame for a fault or wrongdoing
unprecedented: (adj) never done or known before
vindicate: (v) clear (someone) of blame or suspicion
idiosyncratic: (adj) an unusual way in which a particular person behaves or thinks
esoteric: (adj) intended for only a small number of people with a specialized knowledge
ambiguous: (adj) open to more than one interpretation; having a double meaning
erroneous: (adj) wrong; incorrect
eradicate: (v) destroy completely; put an end to
mundane: (adj) ordinary, commonplace
harmony: (n) agreement; the combination of musical notes to produce a pleasing sound
revived: (v) restore to life or consciousness
meticulous: (adj) showing great attention to detail; very careful and precise
perceptive: (adj) having or showing sensitive insight
revolutionary: (adj) constituting or bringing about a major or fundamental change
circumvent: (v) find a way around (an obstacle); overcome (a problem or difficulty)
economical: (adj) using no more of something than is necessary
protected: (v) kept safe from harm or injury
argumentative: (adj) given to expressing divergent or opposite views
resolute: (adj) admirably purposeful, determined, and unwavering
enervated: (v) cause (someone) to feel drained of energy or vitality; weaken
trivial: (adj) of little value or importance
histrionic: (adj) overly theatrical or melodramatic in character or style
beguile: (v) charm or enchant (someone), sometimes in a deceptive way.
onerous: (adj) involving an amount of effort and difficulty that is oppressively burdensome
solicitous: (adj) characterized by or showing interest or concern
effusive: (adj) expressing feelings of gratitude in an unrestrained manner
wistful: (adj) having or showing a feeling of vague or regretful longing
dilettante: (n) a person who cultivates an area of interest without real commitment
despondency: (n) state of low spirits caused by loss of hope or courage
augment: (v) make (something) greater by adding to it; increase
corroborate: (v) confirm or give support to (a statement, theory, or finding
diminutive: (adj) extremely or unusually small
banality: (n) something that is boring or ordinary; unoriginality
compassion: (n) sympathetic pity and concern for the sufferings or misfortunes of others
commendable: (adj) deserving praise
politicized: (v) cause (an activity or event) to become political in character
marginal: (adj): not very important; slight or small; not included in the main part
detachment: (n) lack of emotion or of personal interest
egotistical: (adj) excessively conceited or absorbed in oneself; self-centered
philanthropic: (adj) seeking to promote the welfare of others
reconcile: (v) restore friendly relations between; make (one account) consistent with another
figurative: (adj) departing from a literal use of words; metaphorical
inconsequential: (adj) not important or significant
reciprocity: (n) the practice of exchanging things with others for mutual benefit
extravagant: (adj) lacking restraint in spending money or using resources
fabricated: (v) invent or concoct (something), typically with deceitful intent
diversity: (n) a range of different things
atypical: (adj) not representative of a type, group, or class
discriminating: (adj) having or showing refined taste or good judgment
sentimental: (adj) of or prompted by feelings of tenderness, sadness, or nostalgia
expose: (v) make (something) visible, typically by uncovering it
frugality: (n) the quality of being economical with money or food; thriftiness
reluctant: (adj) unwilling and hesitant; disinclined
autonomy: (n) freedom from external control or influence; independence
conditional: (adj) subject to one or more conditions or requirements being met
foreshadowing: (v) be a warning or indication of (a future event)
wry: (adj) using or expressing dry, esp. mocking, humor
symbolic: (adj) serving as a visible symbol for something abstract
obsequious: (adj) obedient or attentive to an excessive or servile degree
contentious: (adj) causing or likely to cause an argument; controversial
inscrutable: (adj) impossible to understand or interpret
loquacious: (adj) tending to talk a great deal; talkative
whimsical: (adj) unusual in a playful or amusing way; not serious
eulogize: (v) praise highly in speech or writing
adroit: (adj) clever or skillful in using the hands or mind
provincial: (adj) outside the capital city; unsophisticated or narrow-minded
maverick: (n) an unorthodox or independent-minded person
dilatory: (adj) slow to act
exploit: (v) use in an unfair or selfish way; make full use of and derive benefit from
steadfast: (adj) resolutely or dutifully firm and unwavering
bitter: (adj) resentful because of one's bad experiences or a sense of unjust treatment
belied: (v) disguise or contradict; fail to fulfill or justify
irate: (adj) feeling or characterized by great anger
cryptic: (adj) having a meaning that is mysterious or obscure
obscure: (adj) not discovered or known about; uncertain
remorse: (n) deep and painful regret for wrongdoing
ornate: (adj) made in an intricate shape or decorated with complex patterns
cliche: (n) a phrase or opinion that is overused and betrays a lack of original thought
charismatic: (adj) exercising a compelling charm that inspires devotion in others
a cappella: without accompaniment
à la carte: priced separately
a priori: reasoning based on general principles
aback: unexpected, surprised
abacus: counting device
abandon: desert, forsake
abase: degrade
abash: humiliate, embarrass
abate: lessen, subside
abatement: alleviation
abbey: monastery
abbreviate: shorten
abdicate: relinquish power or position
abdomen: belly
abduct: kidnap
aberrant: abnormal
abet: aid, encourage (typically of crime)
abeyance: postponement
abhor: detest
abide: submit, endure
abject: wretched
abjure: renounce
ablate: cut away
ablution: cleansing
abode: home
abolish: annul, eliminate
abominable: detestable
aboriginal: indigenous, native
abortive: unsuccessful
abound: be plentiful
abreast: side-by-side
abridge: shorten
abroad: overseas
abrogate: cancel
abrupt: ending suddenly
abscess: infected and inflamed tissue
abscond: to run away (secretly)
absolve: acquit, free from blame
abstain: refrain
abstract: theoretical, intangible
abstruse: difficult to understand
abut: touch, border on
abysmal: deficient, sub par
abyss: chasm
academy: school
accede: yield, agree
accentuate: emphasize
accession: attainment of rank
accessory: attachment, accomplice
acclaim: recognition, fame
acclimate: accustom oneself to a climate, adjust